{
    "A" : "ɑ",
    "Q" : "ɒ",
    "Ù" : "dʒ",
    "Z" : "ʒ",
    "N" : "ŋ",
    "Í" : "tʃ",
    "V" : "ʌ",
    "@" : "ə",
    "U" : "ʊ",
    "S" : "ʃ",
    "E" : "ɛ",
    " h " : "ʰ",
    "O" : "ɔ",
    ";" : "ː",
    "I" : "ɪ"
}